3D Kanojo: Real Girl	Watched
Absolute Duo	Watched
Accel World	Watched
Aho Girl	Watched
Aka Akatoretachi no Monogatari	Manga
Akagami no Shiroyuki-hime	Watched
Akame ga Kill	Watched
Angel Beats!	Watched
Anohana: The Flower We Saw That Day	Watched
Another	Watched
Ansatsu Kyoushitsu	Watched
Ao no Exorcist	Watched
Avatar	Watched
Baka to Test to Shoukanjuu	Watched
Bakamonogatari	Watching
BanG Dream!	Updated
Black Bullet	Watched
Bleach	Watching
Blend S	Watched
Blood Lad	Watched
Blood-C	Watched
Boku no Hero Academia	Watched
Boku no Kanojo ga Majimesugiru Sho-bitch na Ken	Watched
Btooom!	Watched
Bungou Stray Dogs	Watched
Busou Shoujo Machiavellianism	Watched
Byousoku 5 Centimeter	Watched
Campione!	Watched
Charlotte	Watched
Chuunibyou Demo Koi Ga Shitai	Watched
Clannad	Watched
Clockwork Planet	Watched
Corpse Party: Tortured Soul	Watched
Danmachi	Watched
Danna Ga Nani Wo Itteiru Ka Wakaranai Ken	Special
Darling in the FranXX	Watched
Date a Live	Watched
Deadman Wonderland	Watched
Death March kara Hajimaru Isekai Kyousoukyoku	Watched
Death Note	Watched
Death Parade	Watched
Denpa Onna to Seishun Otoko	Watched
Dog Days	Watched
Durarara!	Watched
Elfen Lied	Watched
Eromanga-Sensei	Watched
Fairy Tail	Watched
Fate Series	Watching
Gabriel Dropout	Updated
Gakusen Toshi Asterisk	Watched
Gamers!	Watched
Gate: Jieitai Kanochi nite, Kaku Tatakaeri	Watched
Girls' Last Tour	Synced
Golden Time	Watched
Granblue Fantasy	Updated
Grim Reaper and 4 Girlfriends	Manga
Guilty Crown	Watched
Hagure Yuusha no Aesthetica	Watched
Hai to Gensou no Grimgar	Watched
Hajimete no Gal	Watched
Hataraku Maou-sama!	Watched
Hidan no Aria	Watched
High School of the Dead	Watched
Highschool DxD	Watched
Himouto! Umaru-chan	Watched
Hundred	Watched
Hyakuren no Haou to Seiyaku Valkyria	Watched
Hyouka	Watched
Ichiban Ushiro no Daimaou	Watched
Imouto sae Ireba Ii	Watched
In this Corner of the World	Watched
Inou-Battle wa Nichijou-kei no Naka de	Watched
Inuyashiki	Watched
IS: Infinite Stratos	Watched
Isekai Maou to Shoukan Shoujou no Dorei Majutsu	Watched
Isekai Shokudou	Watched
Isekai wa Smartphone to Tomo Ni	Watched
Ixion Saga DT	Watching
Jitsu wa Watashi wa	Watched
Just Because!	Watched
Juuni Taisen	Watched
Juuou Mujin no Fafnir	Watched
K Project	Watched
Kakegurui	Watched
Karakai Jozu no Takagi-san	Updated
Kaze no Stigma	Watched
Kekkai Sensen	Watched
Kimi no Na wa	Watched
Kimi wa Midara na Boku no Joou	Manga
Kiss x Sis	Watched
Kiznaiver	Watched
Knights & Magic	Watched
Kobayashi-san Chi no Maid Dragon	Watched
Koe no Katachi	Watched
Koi to Senkyou to Chocolate	Watched
Koi to Uso	Watched
Kono Subarashii Sekai ni Shukufuku Wo!	Watched
Kore wa Zombie Desu ka?	Watched
Koutetsujou no Kabaneri	Watched
Kuusen Madoushi Kouhosei no Kyoukan	Watched
Kyoukai no Kanata	Watched
Log Horizon	Watched
Lucky Star	Watched
Madan no Ou to Vanadis	Watched
Magi	Watching
Mahou Sensou	Watched
Mahouka Koukou no Rettousei	Watched
Mangaka-san to Assistant-san	Watched
Maou na Ore to Ghoul no Yubiwa	Manga
Maoyuu Maou Yuusha	Watched
Masamune-kun no Revenge	Watched
Masou Gakuen HxH	Watched
Mayo Chiki!	Watched
Mirai Nikki	Watched
Mob Psycho 100	Watched
Mondaiji-tachi ga Isekai kara Kuru Sou Desu yo?	Watched
Monogatari Series	Watching
Monster Musume No Iru Nichijou	Watched
Musaigen no Phantom World	Watched
My Teen Romantic Comedy SNAFU	Watched
Nanatsu no Taizai	On Hold
Naruto	Updated
Neon Genesis Evangalion	Syncing
Net-juu no Susume	Watched
Netoge No Yome	Watched
New Game!	Watched
Nisekoi	Watched
No Game No Life	Watched
Noragami	Watched
One Piece	On Hold
One Punch Man	Watched
Ore Monogatari	Watched
OreImo	Watched
Ousama Game	Watched
Outbreak Company	Watched
Overlord	Updated
Owari no Seraph	Watched
Parasyte	Watched
Poputepipiku	Synced
Psycho-Pass	Watched
Rakudai Kishi no Cavalry	Watched
Re:CREATORS	Watched
Re:Zero kara Hajimeru Isekai Seikatsu	Updated
Relife	Watched
Renai Boukun	Watched
Rising x Rydeen	Manga
Rokka no Yuusha	Watched
Rokudenashi Majutsu Koushi to Akashic Records	Watched
Ryuuou no Oshigoto	Watched
Saenai Heroine no Sodatekata	Watched
Saijaku Muhai no Bahamut	Watched
Sakamoto desu ga?	Watched
Sakurasou no Pet na Kanojo	Watched
Satsuriku no Tenshi	Updated
School Days	Watched
Seiken no Blacksmith	Watched
Seiken Tsukai no World Break	Watched
Seirei Tsukai no Blade Dance	Watched
Sen to Chihiro no Kamikakushi	Watched
Shichisei no Subaru	Watched
Shigatsu wa Kimi no Uso	On Hold
Shingeki no Kyojin	On Hold
Shinmai Maou no Testament	Watched
Shomin Sample	Watched
Shoujo Shuumatsu Ryoukou	Watched
Sin: Nanatsu no Taizai	Watched
Sousei no Onmyouji	Watched
Steins;Gate	Watched
Strike the Blood	Watched
Summer Wars	Watched
Sword Art Online	Updated
Tada-kun wa Koi wo Shinai	Watched
Taimadou Gakuen 35 Shiken Shoutai	Watched
Tales of Zestiria the X	Watched
Tanaka-kun wa Itsumo Kedaruge	Watched
The Garden of Words	Watched
The Grim Reaper & Agent Cavalier	Manga
There She Is!!	Special
To Love-Ru	Watched
Toki wo Kakeru Shoujo	Watched
Tokyo Ghoul	Updated
Tonari no Kaibutsu-kun	Watched
Tora Kiss:A School Odyssey	Manga
Toradora	Watched
Trinity Seven	Watched
Tsugumomo	Watched
Tsuki ga Kirei	Watched
Tsurezure Children	Watched
Ultimate Antihero	Manga
Usagi Drop	Watched
WorldEnd	Watched
Wotaku no Koi wa Muzukashi	Watched
Yokoso Jitsuryoku Shijou Shugi no Kyoushitse e	Watched
Yosuga no Sora	Synced
Youjo Senki	Watched
Zero kara Hajimeru no Mahou no Sho	Watched
